1111111111
1100C00001
101100C011
1001001001
1P01100001
110000C001
1011000001
1000010E01
1000100001
1111111111